8 15
|-------------|
|...F....-..P.|
|..--.P-......|
|.F.-..-..-...|
|...--.-.--@..|
|....-....-...|
|......F....P.|
|-------------|